--o--ooo
--oooxx-
----ox--
x--ooo--
---oo--x
o--o-o-o
-o--ooo-
-ooo---V
